{
  "id": "TEST",
  "width": 10,
  "height": 10,
  "terrain": [
    [0, 0, 0, 0, 0, 0, 0, 0, 0, 0],
    [0, 1, 1, 0, 2, 2, 0, 1, 0, 0],
    [0, 1, 0, 0, 2, 0, 0, 0, 3, 3],
    [0, 0, 0, 4, 4, 0, 0, 0, 3, 3],
    [0, 0, 0, 0, 0, 0, 0, 0, 0, 0],
    [0, 2, 2, 0, 0, 0, 1, 1, 0, 0],
    [0, 0, 0, 0, 0, 0, 1, 0, 0, 0],
    [0, 0, 3, 3, 0, 0, 0, 0, 0, 0],
    [0, 0, 3, 3, 0, 0, 0, 2, 2, 0],
    [0, 0, 0, 0, 0, 0, 0, 0, 0, 0]
  ],
  "deploy_zones": {
    "player": [
      { "x": 0, "y": 4 },
      { "x": 0, "y": 5 },
      { "x": 1, "y": 4 },
      { "x": 1, "y": 5 }
    ],
    "enemy": [
      { "x": 9, "y": 4 },
      { "x": 9, "y": 5 }
    ]
  }
}
